1 1 1 1 1 1 1 1 1 1 1 1 1 1 1 	 
4 0 5 5 0 5 5 0 5 5 0 5 5 0 2 	 
3 5 5 5 5 5 5 5 5 5 5 5 5 5 4 	 
5 0 3 1 0 3 3 1 3 3 0 1 3 0 5 	 
2 1 3 3 3 1 3 3 3 1 3 3 3 1 3 	 
4 0 2 2 0 2 2 0 2 2 0 2 2 0 3 	 
1 2 2 2 2 2 2 2 2 2 2 2 2 2 1 	 
0 1 0 0 1 0 0 1 0 0 1 0 0 1 0